00000000000000000000000000002000200000000000000000000000200020000000000002000200000000000000000000000200020000000000000000000000000000
00000000000000000000000000002000200000000000000000000000200020000000000002000200000000000000000000000200020000000000000000000000000000
00000000000000000000000000002000200000000000000000000000200020000000000002000200000000000000000000000200020000000000000000000000000000
00000000000000000000000000002000200000000000000000000000200020000000000002000200000000000000000000000200020000000000000000000000000000
00000000000000000000000000002000200000000000000000000000200020000000000002000200000000000000000000000200020000000000000000000000000000
00000000000000000000000000002000200000000000000000000000200020000000000002000200000000000000000000000200020000000000000000000000000000
00000000000000000000000000002000200000000000000000000000200020000000000002000200000000000000000000000200020000000000000000000000000000
00000000000000000000000000002000200000000000000000000000200020000000000002000200000000000000000000000200020000000000000000000000000000
00000000000000000000000000002000200000000000000000000000200020000000000002000200000000000000000000000200020000000000000000000000000000
00000000000000222222222222222000222222222222222222222222200022222222222222000222222222222222222222222200022222222222222200000000000000
00000000000000200000000000002000200000000000000000000000200020000000000002000200000000000000000000000200020000000000000200000000000000
00000000000000200000000000002000200000000000000000000000200020000000000002000200000000000000000000000200020000000000000200000000000000
00000000000000200000000000002000200000000000000000000000200020000000000002000200000000000000000000000200020000000000000200000000000000
00000000000000200000000000002000200000000000000000000000000000000000000000000000000000000000000000000200020000000000000200000000000000
00000000000000200000000000002000200000000000000000000000000000000011000000000000000000000000000000000200020000000000000200000000000000
00000000000000200000000000002000200000000000000000000000000000000022000000000000000000000000000000000200020000000000000200000000000000
00000000000000200000000000000000000000000000000000000000000000000022000000000000000000000000000000000000000000000000000200000000000000
00000000000000200000000000000000000000000000000000000000000000000022000000000000000000000000000000000000000000000000000200000000000000
00000000000000200000000000000000000000000000111111111111111111111122111111111111111111111110000000000000000000000000000200000000000000
00000000000000200000000000000000000100000000000022222222222222222222222222222222222222200000000000100000000000000000000200000000000000
00000000000000200000000000000000000200000000000000000000000000000000000000000000000000000000000000200000000000000000000200000000000000
00000000000000200000000000000000000200000000000000000000000000000000000000000000000000000000000000200000000000000000000200000000000000
00000000000000200000000000001111111211111110000000000000000000000000000000000000000000000001111111211111110000000000000200000000000000
00000000000000210000000000000000000000000000000000000000000000000000000000000000000000000000000000000000000000000000001200000000000000
00000000000000220000000000000000000000000000000000000000000000000000000000000000000000000000000000000000000000000000002200000000000000
00000000000000220000000000000000000000000000000000000000000000000000000000000000000000000000000000000000000000000000002200000000000000
00000000000000221111111111110000000000000000000000000000000000000000000000000000000000000000000000000000001111111111112200000000000000
00000000000000222222222222220000000000000000000000000000000000000000000000000000000000000000000000000000002222222222222200000000000000
00000000000000222222222222221111111111111110000000000000000000000000000000000000000000000001111111111111112222222222222200000000000000
00000000000000000000000000000000000020000000000000000000000000000000000000000000000000000000000002000000000000000000000000000000000000
00000000000000000000000000000000000020000000000000000000000000000000000000000000000000000000000002000000000000000000000000000000000000
00000000000000000000000000000000000020000001000000000000000000000000000000000000000000000010000002000000000000000000000000000000000000
00000000000000000000000000000000000020000002000000000000000000000000000000000000000000000020000002000000000000000000000000000000000000
00000000000000000000000000000000000020000002000000000000000000000000000000000000000000000020000002000000000000000000000000000000000000
00000000000000000000000000000000000020000002111111111111111000000011000000011111111111111120000002000000000000000000000000000000000000
00000000000000000000000000000000000020000000000000000000000000000022000000000000000000000000000002000000000000000000000000000000000000
00000000000000000000000000000000000020000000000000000000000000000022000000000000000000000000000002000000000000000000000000000000000000
00000000000000000000000000000000000020000000000000000000000000000022000000000000000000000000000002000000000000000000000000000000000000
00000000000000000000000000000000000020000000000000000000000001111122111110000000000000000000000002000000000000000000000000000000000000
00000000000000000000000000000000000020000000000000000000001112222222222221110000000000000000000002000000000000000000000000000000000000
00000000000000000000000000000000000020000001000000000000000000000000000000000000000000000010000002000000000000000000000000000000000000
00000000000000000000000000000000000020000002000000000000000000000000000000000000000000000020000002000000000000000000000000000000000000
00000000000000000000000000000000000020000002000000000000000000000000000000000000000000000020000002000000000000000000000000000000000000
00000000000000000000000000000000000020000002111111111111111000000000000000011111111111111120000002000000000000000000000000000000000000
00000000000000000000000000000000000020000000000000000000000000000000000000000000000000000000000002000000000000000000000000000000000000
00000000000000000000000000000000000020000000000000000000000000000000000000000000000000000000000002000000000000000000000000000000000000
00000000000000000000000000000000000020000000000000000000000000000000000000000000000000000000000002000000000000000000000000000000000000
00000000000000000000000000000000000021111111111111111111111111111111111111111111111111111111111112000000000000000000000000000000000000
00000000000000000000000000000000000022222222222222222222222222222222222222222222222222222222222222000000000000000000000000000000000000
00000000000000000000000000000000000022222222222222222222222222222222222222222222222222222222222222000000000000000000000000000000000000
00000000000000000000000000000000000022222222222222222222222222222222222222222222222222222222222222000000000000000000000000000000000000
00000000000000000000000000000000000022222222222222222222222222222222222222222222222222222222222222000000000000000000000000000000000000
00000000000000000000000000000000000022222222222222222222222222222222222222222222222222222222222222000000000000000000000000000000000000